###########
#SXO      #
#XXXO     #
###### ####
#T        #
###########