#####################################################################################################
# # #         #     #   #   #     # #     #             #     # #     # #               #       #   #
# # ### # ##### ####### # ### # ### ### ### # # # # ####### ### ##### # ### ######### # ### ####### #
#       #   # #   #       # # #   #         # # # # # #       #           #   # # #   # #   #   # # #
# ### ##### # # # # ### ### # ### # # # # ########### # # # # ######### ### ### # ### ##### # ### # #
#   # #       # #     # #       #   # # # # # #     # # # # #   #   #             # #   # # #   #   #
####### ### # # # ################# ##### # # ##### # # # ##### # # ####### ### ### ##### # ### # ###
#   #     # #  S#   # # #     # # #     #   #     #   # #     #   # #   #     #     # #   #   #     #
# ##### ######### ### # # # ### # # ########### ### # ### # ########### # ##### ##### # ### # ##### #
#       # #       #   #   #     #   #     # #       #     #   #   #     # #   #     # #   # #       #
# # # # # ### # # ### ##### ### # # ### # # # ##### ############# ##### ##### ##### # # ####### #####
# # # # #     # # #   #     #     #   # # #   #   # #         #   # #           # #   # # #     #   #
### ### ### ##### ### # # ### ##### ##### ##### ### ### ####### # # ####### ### # # ### # ### ### ###
#     #   #     # # #   #   #   #   # #       #   #         #   #     # #   #     # # #   #   #     #
# # ######### ### # # ### # # ### # # ### # # ### # ####### ### ### ### ### # ##### # # ##### # ### #
# #   #   #     # # # # # # #   # # #     # # #       #       # # #     #   #       #     #     # # #
# ##### ##### # ### ### # ####### ######### ######### # ### ### # # ############# # # ##### ### # # #
# #       #   #           #   #         #         #   #   #     #       #         #   #   # # #   # #
##### # ### ##### ##### ##### ######### ### # ### # ### ### ####### ##### ##### # # ##### # # # # ###
#   # # #       #   #   # #   #     # # #   #   # # # #   # #   #       # #     # # #       #   # # #
# # # ######### ### # ### # # ### # # ##### ######### # ### # ### ### # ####### # ### ##### ##### # #
# # # #   # #   #   #   #   #     # # # #       # #   # # #     #   # #         # # #   #   #     # #
# ### # ### ########### ### ####### # # # ##### # # ### # # # ### ### ####### ### # # ### ######### #
#     #       # #         #       # #     #   #     #   # # # # # #   #   #   # #   # #       #     #
### # ####### # ### # # ### # # ######### # # # # ##### # ##### # ##### # # # # ### # ####### # ### #
#   # # # #     # # # # # # # #     #   # # #   #   # #   # #       #   #   #   #     #           # #
### ### # # ### # ### ### # ### # ### ##### ######### # # # ### # ### # ##### ##### ### ##### #######
#     #   #   # # #       # # # # #   # #           #   #   #   # #   #   #     # #   # #   # # #   #
##### ### ### # # # ##### # # # ### # # ### ### # # # ### ####### # ### ######### # ####### ### # # #
# #       #   #   # # #   # #     # # # #     # # #     #   #     #   #       #   #               # #
# # ### ### ### # ### ### # # # ### ### # # ######### ### ### # ########### # ### ##### # ### ##### #
#   # # #     # # #     # # # #   #       # #       #   #   # #   #   #   # # # #       # # #   #   #
##### # # # ##### # ### # ### ######### ### ### ### ### # ####### ### ### # ### ##### # ### # # ### #
# #     # #     #   #       #       #     # #     # #   # # # #       #     #         # #     # #   #
# # ### ##### ##### # # # ### ##### ##### ##### ### # # ### # ##### ##### ####### ######### ####### #
# # # # #       #   # # # #   #   #   #           # # # #   #           # # #         #   # # #   # #
# # # # # ##### # ##### ### ### ### # # ##### # # ####### # ######### ##### ### ##### # ### # # #####
#   #       # # # #   #           # #     #   # # # # #   # #     # # # #     #   #     #           #
### ### ### # # ### # # ##### ############### ### # # ### # ### ### ### # ####### # ### # ######### #
#   # #   # # #   # # # # # # #   #     # #     # #       # # #               # # #   # #     # #   #
# ### ### # # ####### # # # # # ### ##### ##### ### # ##### # # ########### # # ######### # ### # ###
#   #     #       #   # #     #           #   #     #   #         # # #   # # #     # #   # #   #   #
# ##### ##### ##### ### ##### ### ########### ##### ############# # # # # ### # ##### ### ### ### # #
# # #       # #     #   #   #     #       #   # #   #     # #       #   # #     # #   #   #       # #
# # ### ######### # # ### # ### ### # # # ### # # ### # ### # # ### ##### # ### # # # # # # ### #####
# # #       # # # # #     #   #     # # # # #         #   # # # #     #   # #     # # # # # #   #   #
# # ##### ### # ### # # ### ######### # # # # ######### # # ### ##### # ### ### ### ### ##### ##### #
# # #       # #   #   # # # # #       # # #         #   # # #       #     #   #   # # #   # #       #
# # # # ### # ### ### ### ### ######### ### ### # ##### ### # ####### ####### ### # # # ### ### ### #
# #   #   #       #   #     #   #   #   # #   # # # #   # #       # # #         #     # #   #     # #
### ##### # # ### # # # ##### # ### ### # ##### ### ### # ##### ### # ##### ##### ##### ### ### ### #
#   #     # # #   # #   #     #   #       #   #   #   # #   #   #     # #   # #   # #   # #   # #   #
### ##### ### ##### ### # ##### ### ### ### ##### ### # # ####### ### # # ### ##### ##### # # ##### #
#   # # #   # #       # #   # #   # #       # # #     # #   #     # #   # # #   #   # #   # # #     #
### # # ##### ####### # # ### # ##### ####### # ### ####### ### ### ### ### ### ### # # ##### # ### #
#   #       #   # # # #   #     #   #   #             #   #     #         #   #         # #       # #
# # ### ### ##### # ######### ##### ##### # ####### ##### ### ##### # # ##### ### # ### # ### # #####
# # # # #     #   # # #   #   # #   #   # #     #       #   # #     # # #         # #   #     # #   #
# # # ### ##### # # # # # ##### # # # # # ####### # ####### ### # # ######### ####### # ### # ##### #
# # # # #   # # #   # # #   # # # #   # #     # # #   #   #   # # #     #   # # #   # #   # #       #
##### # # ### # ### # ### # # # # # ### ### ### ### ### ##### # # ### # ### # # ### # ##### # ### ###
#     #   # #     #   #   # #     #   # #     # #   # #       # #   # # #   #     #   #   # #   #   #
# # # ### # ### ####### ### # # ### ####### ### ### # # ### ####### ##### # ######### # # # ### #####
# # #       # # #   #   #   # # #     #     # #   #   #   #     #     # # #         # # # # #     # #
# ####### ### # # # # ##### # # ### ####### # # # ####### # ######### # # ####### ### ### # # ##### #
#     #     #   # # # #   #   #   # #     #   # #   # # # #       #     # #         # # # # #     # #
########### # ### ### ### ##### ### ##### ### # ### # # ####### # ### ### ########### # # ### ### # #
#   #     #       #   # #       # # # #       # #   #   #   #   #       # # #             #   # #   #
# ### ####### ##### ### ### ### # ### # # # ####### ### ### ### # ### ### # # ##### ##### # ### #####
#       # # #     #   # #     #   #     # #     #             # # # #     #     #   #   #     #   # #
# # ##### # ### ####### ### ### # ################# # # ### ####### ### ##### ##### # ##### ### ### #
# #                 # # #     # #       # #     # # # # #   #     #     #     # # # #               #
####### ### # ### # # # ####### ### # ### # ##### # # # ######### # ######### # # ##### ### #########
# #   #   # #   # #   #       #   # #   # #   # #   # #     #             #           #   # #   #   #
# # # # ### ### # ### # ####### ######### ### # # # ######### ############# ### ######### ### ##### #
#   # # # #   # # #       # #               # # # # #       #         # #     #   #         # #   # #
# ##### # ##### ##### # # # ####### # # ##### # ### # ##### ########### ### ####### ### ### # # ### #
#         #     #     # #         # # # #   # # # # #   # #           #   # #   # # # #   # # #     #
# # # ############### ########### # # ##### # # # # # # # # ####### ### ####### # ### ### ### ### # #
# # #       # # # # # # #   #   # # #     #           #   #     # # #   # #           #   #     # # #
# ######### # # # # ### ### # ##### ### ### ####### ######### ### # # # # # # ########### # # ### # #
#   # #         # #     #             #     #   #   # #           # # #   # #   # #   # #   #   # # #
# # # # ##### ### # ######### # # # # ### # # ### # # ##### ##### ### ##### # # # # # # # ### ##### #
# # #       #     #     # #   # # # # # # # #   # #     #     #       #     # # #   #   # # #     # #
# ### ####### # ### ##### ####### # ### ### # ##### # # # # ### # ### # ##### ### ####### # ### ### #
# # #   #   # # #     #     #     # #   #       #   # # # #   # # #   #   # #     # #   # # #   # # #
# # # ### # # # # ######### # ####### # ### # ####### # ### # ##### # ##### # ##### # # ### ### # # #
#   # #   #   # # # #   #         #   # #   #   # #   # #   # #   # #   #   #   #     #   #         #
### ####### ##### # # # # ####### ##### # # ##### # ######### ### ### ### ### ####### ##### ##### # #
#     #   #   # #   # # #     # #   # #   # #             # #   #   #     # #T  #         #   # # # #
# ##### ### ### ### # ### # ### # ### ##### ##### ####### # ##### ##### # # # ### ######### ### ### #
# #   #           #   #   #   #       #     # #   # #   # #   #   #   # # # #     #   #   #   # #   #
### # # # # # ##### ### ### ##### ### ### ### # ### ### # # ##### # # # ### ##### # ### ### ### ### #
#   #   # # # #         #       # #   # #   #   # #   # #     # #   #   # #     #         #   #     #
### # ### ### # ####### # ######### # # # ### ### # ### ### # # # # # ### ### ##### ### # # ### ### #
# # # # # #       #   # #         # # # # # # #         #   # # # # #   # #   #       # #     # #   #
# ##### # ### # ##### # ##### ### ##### # # ######### ### # # # ### # # # # ### ### ####### ####### #
#           # #   # #     # # # # #     #   #     #   # # # #   #   # # #   #     #       # # # #   #
# ### ### ##### # # # ##### # # ##### ### ### # ##### # # ### # ### ### # ### ####### ##### # # ### #
#   # #       # # #       #       #           #     #     #   #   # #             #   #           # #
#####################################################################################################
