###########
#S        #
#         #
#         #
#         #
#         #
###### ####
#T        #
###########
