###########
#S........#
#0........#
#1........#
#2........#
#345678...#
######9####
#T43210...#
###########