###########
#S.....   #
#012345.  #
######6####
#T10987.  #
###########